NO ./path_to_the_north_texture
SO ./path_to_the_south_texture
WE ./path_to_the_west_texture


EA ./path_to_the_east_texture           
F 220,100,0

C 225,30,0

11111111111111111111111111111
10000000001100000000000011111
10110000011100000000000011111
10010000000000000000000011111
11111111101100000111000000001
10000000001100000111011111111
111101111111110111000000100001111111
111101111111111011101010100011011111
11000000110110111000000100011011111111 
10000000000000001100010010001011
1000000000000000110101001000100011
10000011101010111110111100111111
11110111111101011101111010001
1111111111111111111111111111111
                            