NO ./texture/north_texture
SO ./texture/south_texture
WE ./texture/west_texture

F 0,100,51

EA ./texture/east_texture


C 125,30,240

11111111111111111111111111111          1111111
100000000111000000000000111111111111111       11
101100000101000000000001111110000000011 1  111
1001000000000000000000011111111111111111 10011
111111111011000001110000000001       11111111
10000000001100000111011111111
111101111111110111000000100001111111
111101111111111011101010100011011111
11000000110110111000000100011011111111 
10000000000000001100010010001011        
1000000000000000110101001000100011   
10000011101010111110111100111111
111101111111010N1101111010001
1111111111111111111111111111111